XXXXXXXXXXXXXXXXXXXXXXXXXXXXXXXXXXXXXXXX
X            X        X                X
X            X        X                X
X            XXXXX    XXXXX            X
X            X            X            X
X    XXXXXXXXX            XXXXXXXXX    X
X                                      X
X                                      X
XXXXXXXXXXXXXXXXXXXXXXXXXXXXXXXXXXXXXXXX

1-
XXXXXXXXXXXXXX
X            X
X            X
X            X
X            X
X    XXXXXXXXX
X             
X             
XXXXXXXXXXXXXX

999999999999999
988888888888899
988888888888899
988888888888899
988888888888899
988889999999999
988888888888881
988888888888881
999999999999999

{-9,-9,-9,-9,-9,-9,-9,-9,-9,-9,-9,-9,-9,-9,-9},
{-9,8,8,8,8,8,8,8,8,8,8,8,8,-9,-9},
{-9,8,8,8,8,8,8,8,8,8,8,8,8,-9,-9},
{-9,8,8,8,8,8,8,8,8,8,8,8,8,-9,-9},
{-9,8,8,8,8,8,8,8,8,8,8,8,8,-9,-9},
{-9,8,8,8,8,-9,-9,-9,-9,-9,-9,-9,-9,-9,-9},
{-9,8,8,8,8,8,8,8,8,8,8,8,8,8,1},
{-9,8,8,8,8,8,8,8,8,8,8,8,8,8,1},
{-9,-9,-9,-9,-9,-9,-9,-9,-9,-9,-9,-9,-9,-9,-9}

2-
 XXXXXXXXXX
 X        X
 X        X
 XXXXX    XXXXX
 X            X
 X            X
              
              
 XXXXXXXXXXXXXX

9999999999999999
9988888888999999
9988888888999999
9999998888999999
9988888888888899
9988888888888899
0888888888888882
0888888888888882
9999999999999999

{-9,-9,-9,-9,-9,-9,-9,-9,-9,-9,-9,-9,-9,-9,-9,-9},
{-9,-9,8,8,8,8,8,8,8,8,-9,-9,-9,-9,-9,-9},
{-9,-9,8,8,8,8,8,8,8,8,-9,-9,-9,-9,-9,-9},
{-9,-9,-9,-9,-9,-9,8,8,8,8,-9,-9,-9,-9,-9,-9},
{-9,-9,8,8,8,8,8,8,8,8,8,8,8,8,-9,-9},
{-9,-9,8,8,8,8,8,8,8,8,8,8,8,8,-9,-9},
{0,8,8,8,8,8,8,8,8,8,8,8,8,8,8,2},
{0,8,8,8,8,8,8,8,8,8,8,8,8,8,8,2},
{-9,-9,-9,-9,-9,-9,-9,-9,-9,-9,-9,-9,-9,-9,-9,-9}

3-
 XXXXXXXXXXXXXXXXXX
 X                X
 X                X
 XXXXX            X
     X            X
     XXXXXXXXX    X
                  X
                  X
 XXXXXXXXXXXXXXXXXX

{-9,-9,-9,-9,-9,-9,-9,-9,-9,-9,-9,-9,-9,-9,-9,-9,-9,-9,-9},
{9,9,8,8,8,8,8,8,8,8,8,8,8,8,8,8,8,8,9},
{9,9,8,8,8,8,8,8,8,8,8,8,8,8,8,8,8,8,9},
{9,9,9,9,9,9,8,8,8,8,8,8,8,8,8,8,8,8,9},
{9,9,9,9,9,9,8,8,8,8,8,8,8,8,8,8,8,8,9},
{9,9,9,9,9,9,9,9,9,9,9,9,9,9,8,8,8,8,9},
{9,9,9,9,1,8,8,8,8,8,8,8,8,8,8,8,8,8,9},
{9,9,9,9,1,8,8,8,8,8,8,8,8,8,8,8,8,8,9},
{-9,-9,-9,-9,-9,-9,-9,-9,-9,-9,-9,-9,-9,-9,-9,-9,-9,-9,-9}
